Unicode and Special Character Test Document

This document tests the RAG pipeline's handling of various character encodings and special characters.

ğŸŒ International Characters ğŸŒ

Chinese (Simplified): ä½ å¥½ä¸–ç•Œï¼äººå·¥æ™ºèƒ½æ­£åœ¨æ”¹å˜æˆ‘ä»¬çš„ç”Ÿæ´»æ–¹å¼ã€‚
Chinese (Traditional): ä½ å¥½ä¸–ç•Œï¼äººå·¥æ™ºæ…§æ­£åœ¨æ”¹è®Šæˆ‘å€‘çš„ç”Ÿæ´»æ–¹å¼ã€‚
Japanese: ã“ã‚“ã«ã¡ã¯ä¸–ç•Œï¼äººå·¥çŸ¥èƒ½ã¯ç§ãŸã¡ã®ç”Ÿæ´»ã‚’å¤‰ãˆã¦ã„ã¾ã™ã€‚
Korean: ì•ˆë…•í•˜ì„¸ìš” ì„¸ê³„! ì¸ê³µì§€ëŠ¥ì´ ìš°ë¦¬ì˜ ì‚¶ì„ ë°”ê¾¸ê³  ìˆìŠµë‹ˆë‹¤.
Arabic: Ù…Ø±Ø­Ø¨Ø§ Ø¨Ø§Ù„Ø¹Ø§Ù„Ù…! Ø§Ù„Ø°ÙƒØ§Ø¡ Ø§Ù„Ø§ØµØ·Ù†Ø§Ø¹ÙŠ ÙŠØºÙŠØ± Ø·Ø±ÙŠÙ‚Ø© Ø­ÙŠØ§ØªÙ†Ø§.
Russian: Ğ—Ğ´Ñ€Ğ°Ğ²ÑÑ‚Ğ²ÑƒĞ¹ Ğ¼Ğ¸Ñ€! Ğ˜ÑĞºÑƒÑÑÑ‚Ğ²ĞµĞ½Ğ½Ñ‹Ğ¹ Ğ¸Ğ½Ñ‚ĞµĞ»Ğ»ĞµĞºÑ‚ Ğ¼ĞµĞ½ÑĞµÑ‚ Ğ½Ğ°Ñˆ Ğ¾Ğ±Ñ€Ğ°Ğ· Ğ¶Ğ¸Ğ·Ğ½Ğ¸.
Hindi: à¤¨à¤®à¤¸à¥à¤¤à¥‡ à¤¦à¥à¤¨à¤¿à¤¯à¤¾! à¤•à¥ƒà¤¤à¥à¤°à¤¿à¤® à¤¬à¥à¤¦à¥à¤§à¤¿à¤®à¤¤à¥à¤¤à¤¾ à¤¹à¤®à¤¾à¤°à¥‡ à¤œà¥€à¤µà¤¨ à¤•à¥‹ à¤¬à¤¦à¤² à¤°à¤¹à¥€ à¤¹à¥ˆà¥¤
Hebrew: ×©×œ×•× ×¢×•×œ×! ×‘×™× ×” ××œ××›×•×ª×™×ª ××©× ×” ××ª ××•×¨×— ×—×™×™× ×•.
Thai: à¸ªà¸§à¸±à¸ªà¸”à¸µà¸Šà¸²à¸§à¹‚à¸¥à¸! à¸›à¸±à¸à¸à¸²à¸›à¸£à¸°à¸”à¸´à¸©à¸à¹Œà¸à¸³à¸¥à¸±à¸‡à¹€à¸›à¸¥à¸µà¹ˆà¸¢à¸™à¸§à¸´à¸–à¸µà¸Šà¸µà¸§à¸´à¸•à¸‚à¸­à¸‡à¹€à¸£à¸²
Greek: Î“ÎµÎ¹Î± ÏƒÎ¿Ï… ÎºÏŒÏƒÎ¼Îµ! Î— Ï„ÎµÏ‡Î½Î·Ï„Î® Î½Î¿Î·Î¼Î¿ÏƒÏÎ½Î· Î±Î»Î»Î¬Î¶ÎµÎ¹ Ï„Î¿Î½ Ï„ÏÏŒÏ€Î¿ Î¶Ï‰Î®Ï‚ Î¼Î±Ï‚.

ğŸ“Š Emoji Test Cases ğŸ“Š

Technology: ğŸ’» ğŸ“± âŒšï¸ ğŸ–¥ âŒ¨ï¸ ğŸ–± ğŸ’¾ ğŸ’¿ ğŸ“€
Science: ğŸ”¬ ğŸ§ª ğŸ§¬ ğŸ”­ ğŸŒ¡ ğŸ§²
Nature: ğŸŒ³ ğŸŒ² ğŸŒ± ğŸŒ¿ ğŸ€ ğŸŒ¾ ğŸŒµ ğŸŒ´
Animals: ğŸ• ğŸˆ ğŸ ğŸ¦ ğŸ˜ ğŸ¦’ ğŸ¦“ ğŸ¼
Weather: â˜€ï¸ â›…ï¸ â›ˆ ğŸŒ§ â„ï¸ âš¡ï¸ ğŸŒˆ ğŸŒª
Food: ğŸ• ğŸ” ğŸŸ ğŸŒ® ğŸŒ¯ ğŸ¥— ğŸ± ğŸœ
Activities: âš½ï¸ ğŸ€ ğŸ¾ ğŸˆ âš¾ï¸ ğŸ¥ ğŸ ğŸ“

âš ï¸ Special Symbols âš ï¸

Mathematical: âˆ‘ âˆ âˆ« âˆ‚ âˆ âˆš âˆ› âˆœ Â± Ã— Ã· â‰ˆ â‰  â‰¤ â‰¥
Currency: $ â‚¬ Â£ Â¥ â‚¹ â‚½ â‚© â‚ª â‚± â‚¦
Punctuation: !@#$%^&*()_+-=[]{}|;:'",.<>?/\~`
Arrows: â†’ â† â†‘ â†“ â†” â†• â‡’ â‡ â‡‘ â‡“ â‡”
Shapes: â–  â–¡ â–ª â–« â— â—‹ â—† â—‡ â˜… â˜†
Music: â™© â™ª â™« â™¬ â™­ â™® â™¯
Cards: â™  â™£ â™¥ â™¦
Chess: â™” â™• â™– â™— â™˜ â™™

ğŸ¯ Mixed Content Testing ğŸ¯

English text mixed with ä¸­æ–‡ characters and Ø§Ù„Ø¹Ø±Ø¨ÙŠØ© and ×¢×‘×¨×™×ª.
Code samples: let Ï€ = 3.14159; let âˆ‘ = sum(array); let Î± = 0.05
Formatted strings: "Hello" + 'ä¸–ç•Œ' + `Ù…Ø±Ø­Ø¨Ø§` + "Ğ—Ğ´Ñ€Ğ°Ğ²ÑÑ‚Ğ²ÑƒĞ¹"

Edge Cases:
- Zero-width characters: â€‹â€Œâ€
- Combining diacritics: Ã  Ã¨ Ã¬ Ã² Ã¹ (composed) vs Ã  Ã¨ Ã¬ Ã² Ã¹ (decomposed)
- Right-to-left text: Ù…Ø±Ø­Ø¨Ø§ Ø§Ù„Ø¹Ø§Ù„Ù… ×©×œ×•× ×¢×•×œ×
- Bidirectional text: Hello Ù…Ø±Ø­Ø¨Ø§ World ×¢×•×œ×!

Testing complete! If you can read all of this correctly, the encoding is working properly. âœ…
